11111111111111111111111111111111111111111111111111
100C0000000000000000000000000000000000000000000001
10000000000C00000000000000000000000000000000000001
10P00000000000000000000000000000000000000000000001
1000001000000000C000000000000000000000000000000001
10000000000000000000000000000000000000000000000001
10001000000000000000000000000000000000000000000001
10000000000000000000000000000000000000000000000001
10000000000000000000000000000000000000000000000001
100100000000000000000C0000000000000000000000000001
10000000000000000000000000000000000000000000000001
10000000000000000C00000000000000000000000000000001
10001000000000000000000000000000000000000000000001
10000000000000000000000000000000000000000000000001
10000010000000000000000000000000000000000000000001
100000000000000000000C0000000000000000000000000001
10000000000000000000000000000000000000000000000001
10000000000000000000000000000000000000000000000001
10000000000000000000000000000000000000000000000001
10000000000000000000000000000000000000000000000001
10000000000000000000000000000000000000000000000001
10000000000000000000000000000000000000000000000001
10000000000000000000000000000000000000000000000001
10000000000000000000000000000000000000000000000001
10000000000000000000000000000000000000000000000001
10000000000000000000000000000000000000000000000001
10000000000000000000000000000000000000000000000001
10000000000000000000000000000000000000000000000001
10000000000000000000000000000000000000000000000001
10000000000000000000000000000000000000000000000001
10000000000000000000000000000000000000000000000001
11111111111111111111111111111111111111111111111111
